0 0 0 0 0 0 0 0 0 0 0 0 0 0 0 0 0 0 0 0 0 0 0 0 0 0 0 0 0 0 0 0 0 0 0 0 0 0 0 0 0 0 0 0 0 0 0 0 0 0 
0 0 0 0 0 0 0 0 0 0 0 0 0 0 0 0 474 474 474 474 474 474 474 474 474 474 474 474 474 474 474 0 0 0 0 0 0 0 0 0 0 0 0 0 0 0 0 0 0 0 
0 0 474 474 474 474 474 474 474 474 0 0 0 0 0 0 474 32 32 32 32 32 32 32 32 32 32 32 32 32 474 0 0 0 0 0 0 0 474 474 474 474 474 474 474 474 474 474 0 0 
0 0 474 32 32 32 32 32 32 474 0 0 0 0 0 0 474 167 167 167 167 167 167 167 167 167 167 167 167 167 474 0 0 0 0 0 0 0 474 32 32 32 32 32 32 32 32 474 0 0 
0 0 474 162 162 162 162 162 162 474 474 474 474 474 474 474 474 5 5 5 5 5 557 5 5 5 5 5 5 5 474 474 474 474 474 474 474 474 474 167 167 167 167 167 167 167 167 474 0 0 
0 0 474 5 5 5 5 5 5 32 32 32 32 32 32 32 32 5 5 5 5 5 5 5 5 5 5 5 557 5 32 32 32 32 32 32 32 32 32 5 5 557 5 5 5 524 5 474 0 0 
0 0 474 5 436 5 5 437 5 166 167 167 167 167 167 167 172 5 5 437 5 5 474 474 474 5 5 5 5 5 166 167 167 167 167 167 167 167 172 5 557 351 229 229 352 5 5 474 0 0 
0 0 474 5 5 5 5 5 5 346 5 5 437 5 5 5 511 5 5 5 5 5 474 474 474 5 5 5 437 5 511 5 5 5 5 437 5 5 511 5 5 317 303 303 382 5 5 474 0 0 
0 0 474 5 437 5 5 437 5 346 5 5 5 5 437 5 511 5 5 5 5 5 474 474 474 5 5 5 5 5 511 5 5 437 5 5 5 5 511 557 5 317 303 303 382 557 5 474 0 0 
0 0 474 5 5 5 5 5 5 474 474 474 474 474 474 474 474 5 5 5 5 5 32 63 33 5 5 5 5 5 474 474 474 474 474 474 474 474 474 5 528 407 441 441 442 5 5 474 0 0 
0 0 474 5 5 5 5 5 5 474 32 32 32 32 32 32 474 5 437 5 5 5 166 171 172 5 5 5 5 5 474 32 32 32 32 32 32 32 474 5 5 5 5 5 5 5 5 474 0 0 
0 0 474 474 474 474 474 474 474 474 0 0 0 0 0 0 474 5 5 5 5 5 5 5 5 5 5 437 5 5 474 0 0 0 0 0 0 0 474 474 474 474 474 474 474 474 474 474 0 0 
0 0 32 32 32 32 32 32 32 32 0 0 0 0 0 0 474 474 474 474 474 474 511 511 511 474 474 474 474 474 474 0 0 0 0 0 0 0 32 32 32 32 32 32 32 32 32 32 0 0 
0 0 0 0 0 0 0 0 0 0 0 0 0 0 0 0 32 32 32 32 32 474 5 5 5 474 32 32 32 32 32 0 0 0 0 0 0 0 0 0 0 0 0 0 0 0 0 0 0 0 
0 0 0 0 0 0 0 0 0 0 0 0 0 0 0 0 0 0 0 0 0 474 5 5 529 474 0 0 0 0 0 0 0 0 0 0 0 0 0 0 0 0 0 0 0 0 0 0 0 0 
0 0 0 0 0 0 0 0 0 0 0 0 0 0 0 0 0 0 0 0 0 474 5 5 5 474 0 0 0 0 0 0 0 0 0 0 0 0 0 0 0 0 0 0 0 0 0 0 0 0 
0 0 0 0 0 0 0 0 0 0 0 0 0 0 0 0 0 0 0 0 0 474 5 529 5 474 0 0 0 0 0 0 0 0 0 0 0 0 0 0 0 0 0 0 0 0 0 0 0 0 
0 0 0 0 0 0 0 0 0 0 0 0 0 0 0 0 0 0 0 0 0 474 5 5 5 474 0 0 0 0 0 0 0 0 0 0 0 0 0 0 0 0 0 0 0 0 0 0 0 0 
0 0 0 0 0 0 0 0 0 0 0 0 0 0 0 0 0 0 0 0 0 474 5 5 5 474 0 0 0 0 0 0 0 0 0 0 0 0 0 0 0 0 0 0 0 0 0 0 0 0 
0 0 0 0 0 0 0 0 0 0 0 0 474 474 474 474 474 474 474 474 474 474 529 5 5 474 474 474 474 474 474 474 474 474 474 0 0 0 0 0 0 0 0 0 0 0 0 0 0 0 
0 0 0 0 0 0 0 0 0 0 0 0 474 32 32 32 32 32 32 32 32 32 511 511 511 32 32 32 32 32 32 32 32 32 474 0 0 474 474 474 474 474 474 474 474 474 474 474 0 0 
0 0 0 0 0 0 0 0 0 0 0 0 474 167 167 167 167 167 167 167 167 172 5 5 5 166 167 167 167 167 167 167 167 167 474 0 0 474 32 32 32 32 32 32 32 32 32 474 0 0 
0 0 0 0 0 0 0 0 0 0 0 0 474 5 5 5 5 5 5 5 5 5 5 5 5 5 5 5 5 5 5 5 5 5 474 0 0 474 167 167 167 167 167 167 167 167 167 474 0 0 
0 0 0 0 0 0 0 0 0 0 0 0 474 5 5 5 423 5 5 5 5 5 5 5 423 5 5 5 5 423 5 5 5 5 474 474 474 474 5 5 5 5 5 5 5 5 423 474 0 0 
0 0 0 0 0 0 0 0 0 0 0 0 474 5 5 5 5 5 5 5 5 5 5 5 5 5 5 5 5 5 5 5 5 5 32 32 32 32 5 5 346 346 346 346 346 5 5 474 0 0 
0 0 0 0 0 0 0 0 0 0 0 0 474 5 5 5 5 5 47 5 5 5 5 5 5 5 5 436 47 5 5 5 5 5 166 167 167 172 423 5 346 5 5 5 346 5 5 474 0 0 
0 0 0 0 0 0 0 0 0 0 0 0 474 5 5 5 423 5 47 5 5 5 5 5 5 5 5 5 47 5 5 5 5 5 511 5 5 511 5 5 346 5 5 5 346 5 5 474 0 0 
0 0 0 0 0 0 0 0 0 0 0 0 474 5 5 5 5 5 47 5 5 5 436 436 5 5 5 5 47 5 5 5 5 5 511 5 5 511 5 5 346 5 423 5 346 5 423 474 0 0 
0 0 0 0 0 0 0 0 0 0 0 0 474 5 5 5 5 5 47 5 5 5 360 361 5 5 5 5 47 5 5 423 5 5 511 5 5 511 5 5 346 5 5 5 346 5 5 474 0 0 
0 0 0 0 0 0 0 0 0 0 0 0 474 5 5 5 5 5 32 5 5 5 5 364 5 5 436 5 32 5 5 5 5 5 474 474 474 474 5 5 346 5 5 5 346 5 5 474 0 0 
0 0 0 0 0 0 0 0 0 0 0 0 474 5 5 423 5 5 163 5 5 5 5 5 5 5 5 5 163 5 5 5 5 5 474 32 32 474 5 5 346 346 346 346 346 5 5 474 0 0 
0 0 0 0 0 0 0 0 0 0 0 0 474 5 5 5 5 5 5 5 5 5 5 5 5 5 5 5 5 5 5 5 5 5 474 0 0 474 5 423 5 5 5 5 5 423 5 474 0 0 
0 0 0 0 0 0 0 0 0 0 0 0 474 5 5 5 5 5 5 5 5 5 436 5 5 5 5 5 5 5 5 5 5 5 474 0 0 474 5 5 5 5 5 5 5 5 5 474 0 0 
0 0 0 0 0 0 0 0 0 0 0 0 474 5 5 5 5 5 5 5 5 5 5 5 5 5 5 5 436 5 5 5 5 5 474 0 0 474 474 474 474 511 511 346 474 474 474 474 0 0 
0 0 0 0 0 0 0 0 0 0 0 0 474 474 474 474 474 474 474 474 474 474 474 474 474 474 474 474 474 474 474 474 474 474 474 0 0 32 32 32 474 5 5 5 474 32 32 32 0 0 
0 0 0 0 0 0 0 0 0 0 0 0 32 32 32 32 32 32 32 32 32 32 32 32 32 32 32 32 32 32 32 32 32 32 32 0 0 0 0 0 474 5 5 5 474 0 0 0 0 0 
0 0 0 0 0 0 0 0 0 0 0 0 0 0 0 0 0 0 0 0 0 0 0 0 0 0 0 0 0 0 0 0 0 0 0 0 0 0 0 0 474 5 5 423 474 0 0 0 0 0 
0 0 0 0 474 474 474 474 474 474 474 474 474 474 474 474 474 474 474 0 0 0 0 0 0 0 0 0 0 0 0 0 0 0 0 0 0 0 0 0 474 5 423 5 474 0 0 0 0 0 
0 0 0 0 474 32 32 32 32 32 32 32 32 32 32 32 32 32 474 0 0 0 0 0 0 0 0 0 0 0 0 0 0 0 0 0 0 474 474 474 474 5 5 5 474 474 474 474 0 0 
0 0 0 0 474 167 167 167 167 167 167 167 167 167 167 167 167 167 474 0 0 0 0 0 0 0 0 0 0 0 0 0 0 0 0 0 0 474 32 32 32 511 511 511 32 32 32 474 0 0 
0 0 0 0 474 45 45 45 45 45 45 45 45 45 45 45 45 494 474 474 474 474 474 474 474 474 474 474 474 474 474 474 474 474 474 474 474 474 167 167 172 5 5 5 166 167 167 474 0 0 
0 0 0 0 474 45 45 45 437 45 437 45 45 45 437 45 45 494 32 32 32 32 32 32 32 32 32 32 32 32 32 32 32 32 32 32 32 32 45 45 45 437 45 45 45 45 437 474 0 0 
0 0 0 0 474 45 45 45 45 45 45 45 45 45 45 45 45 5 166 167 167 167 167 167 167 167 167 167 167 167 167 167 167 167 167 167 167 172 423 437 45 45 45 437 45 45 45 474 0 0 
0 0 0 0 474 45 45 45 45 464 45 437 45 45 45 45 45 45 511 45 45 45 437 45 45 45 45 45 45 437 437 45 45 45 437 45 45 511 45 45 423 45 45 45 45 45 45 474 0 0 
0 0 0 0 474 45 45 464 45 45 45 45 45 45 45 45 45 45 511 45 45 45 45 437 45 45 45 45 45 45 437 45 45 45 45 45 45 511 45 45 45 45 45 45 45 437 45 474 0 0 
0 0 0 0 474 45 45 45 45 45 45 45 45 45 437 45 45 45 474 474 474 474 474 474 474 474 474 474 474 474 474 474 474 474 474 474 474 474 45 423 45 45 437 45 45 45 45 474 0 0 
0 0 0 0 474 45 45 45 45 45 437 45 45 45 45 45 45 45 474 32 32 32 32 32 32 32 32 32 32 32 32 32 32 32 32 32 32 474 45 45 45 45 45 45 45 45 45 474 0 0 
0 0 0 0 474 45 45 45 45 45 45 45 45 45 45 45 45 465 474 0 0 0 0 0 0 0 0 0 0 0 0 0 0 0 0 0 0 474 474 474 474 474 474 474 474 474 474 474 0 0 
0 0 0 0 474 474 474 474 474 474 474 474 474 474 474 474 474 474 474 0 0 0 0 0 0 0 0 0 0 0 0 0 0 0 0 0 0 32 32 32 32 32 32 32 32 32 32 32 0 0 
0 0 0 0 32 32 32 32 32 32 32 32 32 32 32 32 32 32 32 0 0 0 0 0 0 0 0 0 0 0 0 0 0 0 0 0 0 0 0 0 0 0 0 0 0 0 0 0 0 0 
