0 0 0 0 0 0 0 0 0 0 0 0 0 0 0 0 0 0 0 0 0 0 0 0 0 0 0 0 0 0 0 0 0 0 0 0 0 0 0 0 0 0 0 0 0 0 0 0 0 0 0 0 0 12 12 12 12 12 12 12 12 12 12 12 12 12 12 12 12 12 12 12 12 12 12 12 12 12 12 12 12 12 12 12 12 12 12 12 12 12 12 12 12 12 12 12 12 12 12 12 
0 0 0 0 0 0 0 0 0 0 0 0 0 0 0 0 0 3 3 3 3 3 3 3 3 3 3 3 3 3 3 3 3 0 0 0 0 0 0 0 0 0 0 0 0 0 0 0 0 0 0 0 0 0 12 12 12 12 12 12 12 12 12 12 12 12 12 12 12 12 12 12 12 12 12 12 12 12 12 12 12 12 12 12 12 12 12 12 12 12 12 12 12 12 12 12 12 12 12 12 
0 0 0 0 0 0 0 0 0 0 0 0 0 0 0 0 0 3 1 1 1 1 1 1 1 1 1 1 1 1 1 1 3 0 0 0 0 0 0 0 0 0 0 0 0 0 0 0 0 0 0 0 0 0 0 0 12 12 12 12 12 12 12 12 12 12 12 12 12 12 12 12 12 12 12 12 12 12 12 12 12 12 12 12 12 12 12 12 12 12 12 12 12 12 12 12 12 12 12 12 
0 0 0 0 0 0 0 0 0 0 0 0 0 0 0 0 0 3 4 4 4 4 4 4 4 4 4 4 4 4 4 4 3 0 0 0 0 3 3 3 3 3 3 3 3 3 3 3 0 0 0 0 0 0 0 0 12 12 12 12 12 12 12 12 12 12 12 12 12 12 12 12 12 12 12 12 12 12 12 12 12 12 12 12 12 12 3 3 3 3 3 3 3 3 3 3 3 12 12 12 
0 0 3 3 3 3 3 3 3 3 3 0 0 0 0 0 0 3 2 2 2 2 2 2 2 2 2 2 2 2 2 2 3 0 0 0 0 3 1 1 1 1 1 1 1 1 1 3 0 0 0 0 0 0 0 0 0 0 0 12 12 12 12 12 12 12 12 12 12 12 12 12 12 12 12 12 12 12 12 12 12 12 12 12 12 12 3 1 1 1 1 1 1 1 1 1 3 12 12 12 
0 0 3 1 1 1 1 1 1 1 3 0 0 0 0 0 0 3 2 2 2 2 2 2 2 2 2 2 2 2 2 2 3 0 0 0 0 3 4 4 4 4 4 4 4 4 4 3 0 0 0 0 0 0 0 0 0 0 0 0 12 12 12 12 12 12 12 12 12 12 12 12 12 12 12 12 12 12 12 12 12 12 12 12 12 12 3 4 4 4 4 4 4 4 4 4 3 12 12 12 
0 0 3 4 4 4 4 4 4 4 3 3 3 3 3 3 3 3 2 2 2 2 2 2 2 2 2 2 2 2 2 2 3 3 3 3 3 3 2 2 2 2 2 2 2 2 2 3 3 3 3 3 3 3 3 3 3 3 3 3 3 3 3 13 12 12 12 12 12 12 12 12 12 12 12 12 12 21 3 3 3 3 3 3 3 3 3 2 2 2 2 2 2 2 2 2 3 12 12 12 
0 0 3 2 2 2 2 2 2 2 1 1 1 1 1 1 1 1 2 2 2 2 2 2 2 2 2 2 2 2 2 2 1 1 1 1 1 1 2 2 9 10 10 10 10 10 11 1 1 1 1 1 1 1 1 1 1 1 1 1 1 1 1 13 12 12 12 12 12 12 12 12 12 12 12 21 16 17 1 1 1 1 1 1 1 1 1 2 2 2 2 2 2 2 2 2 3 12 12 12 
0 0 3 2 2 2 2 2 2 2 5 4 4 4 4 4 4 6 2 2 2 2 2 2 3 3 3 2 2 2 2 2 5 4 4 4 4 6 2 2 13 12 12 12 12 12 19 10 10 10 10 10 10 10 10 10 10 10 10 10 10 10 10 20 12 12 12 12 12 12 12 12 12 12 21 17 2 2 5 4 4 4 4 4 4 4 6 2 2 2 2 2 2 2 2 2 3 12 12 12 
0 0 3 2 2 2 2 2 2 2 2 2 2 2 2 2 2 2 2 2 2 2 2 2 3 3 3 2 2 2 2 2 2 2 2 2 2 2 2 2 13 12 12 12 12 12 12 12 12 12 12 12 12 12 12 12 12 12 12 12 12 12 12 12 12 12 12 12 12 12 12 12 12 12 14 2 2 2 2 2 2 2 2 2 2 2 2 2 2 2 2 2 2 2 2 2 3 12 12 12 
0 0 3 2 2 2 2 2 2 2 2 2 2 2 2 2 2 2 2 2 2 2 2 2 3 3 3 2 2 2 2 2 2 2 2 2 2 2 2 2 13 12 12 12 12 12 21 16 16 16 16 16 16 16 16 16 16 16 16 16 16 16 16 22 12 12 12 12 12 12 12 12 12 12 14 2 2 2 2 2 2 2 2 2 2 2 2 2 2 2 2 2 2 2 2 2 3 12 12 12 
0 0 3 2 2 2 2 2 2 2 3 3 3 3 3 3 3 3 2 2 2 2 2 2 1 1 1 2 2 2 2 2 3 3 3 3 3 3 2 2 15 16 16 16 16 16 17 3 3 3 3 3 3 3 3 3 3 3 3 3 3 3 3 13 12 12 12 12 12 12 12 12 12 12 19 11 2 2 3 3 3 3 3 3 3 3 3 2 2 2 2 2 2 2 2 2 3 12 12 12 
0 0 3 2 2 2 2 2 2 2 3 1 1 1 1 1 1 3 2 2 2 2 2 2 5 4 6 2 2 2 2 2 3 1 1 1 1 3 2 2 2 2 2 2 2 2 2 3 1 1 1 1 1 1 1 1 1 1 1 1 1 1 1 13 12 12 12 12 12 12 12 12 12 12 12 19 10 11 1 1 1 1 1 1 1 1 3 2 2 2 2 2 2 2 2 2 3 12 12 12 
0 0 3 3 3 3 3 3 3 3 3 0 0 0 0 0 0 3 2 2 2 2 2 2 2 2 2 2 2 2 2 2 3 0 0 0 0 3 2 2 2 2 2 2 2 2 2 3 10 10 10 10 10 10 10 10 10 10 10 10 10 10 10 20 12 12 12 12 12 12 12 12 12 12 12 12 12 19 10 10 10 10 10 10 10 10 3 3 3 3 2 2 2 3 3 3 3 12 12 12 
0 0 1 1 1 1 1 1 1 1 1 0 0 0 0 0 0 3 2 2 2 2 2 2 2 2 2 2 2 2 2 2 3 0 0 0 0 3 3 3 3 18 18 18 3 3 3 3 12 12 12 12 12 12 12 12 12 12 12 12 12 12 12 12 12 12 12 12 12 12 12 12 12 12 12 12 12 12 12 12 12 12 12 12 12 12 1 1 1 3 2 2 2 3 1 1 1 12 12 12 
0 0 0 0 0 0 0 0 0 0 0 0 0 0 0 0 0 3 2 2 2 2 2 2 2 2 2 2 2 2 2 2 3 0 0 0 0 1 1 1 3 2 2 2 3 1 1 1 12 12 12 12 12 12 12 12 12 12 12 12 12 12 12 12 12 12 12 12 12 12 12 12 12 12 12 12 12 12 12 12 12 12 12 12 12 12 10 10 10 3 2 2 2 3 10 10 10 12 12 12 
0 0 0 0 0 0 0 0 0 0 0 0 0 0 0 0 0 3 3 3 3 3 3 3 18 18 18 3 3 3 3 3 3 0 0 0 0 0 0 0 3 2 2 2 3 12 12 12 12 12 12 12 12 12 12 12 12 12 12 12 12 12 12 12 12 12 12 12 12 12 12 12 12 12 12 12 12 12 12 12 12 12 12 12 12 12 12 12 12 3 2 2 2 3 12 12 12 12 12 12 
0 0 0 0 0 0 0 0 0 0 0 0 0 0 0 0 0 1 1 1 1 1 1 3 3 3 3 3 1 1 1 1 1 0 0 0 0 0 0 0 3 2 2 2 3 12 12 12 12 12 12 12 12 12 12 12 12 12 12 12 12 12 12 12 12 12 12 12 12 12 12 12 12 12 12 12 12 12 12 12 12 12 12 12 12 12 12 12 12 3 2 2 2 3 12 12 12 12 12 12 
0 0 0 0 0 0 0 0 0 0 0 0 0 0 0 0 0 0 0 0 0 0 0 1 1 1 1 1 0 0 0 0 0 0 0 0 0 0 0 0 3 2 2 2 3 12 12 12 12 12 12 12 12 12 12 12 12 12 12 12 12 12 12 12 12 21 16 16 16 16 16 16 22 12 12 12 12 12 12 12 12 12 12 12 12 12 12 12 12 3 2 2 2 3 12 12 12 12 12 12 
0 0 0 0 0 0 0 0 0 0 0 0 0 0 0 0 0 0 0 0 0 0 0 0 0 0 0 0 0 0 0 0 0 0 0 0 0 0 0 0 3 2 2 2 3 12 12 12 12 12 12 12 12 12 12 12 12 12 12 12 12 12 12 12 12 14 2 2 2 2 2 2 13 12 12 12 12 12 12 12 12 12 12 12 12 12 12 12 12 3 2 2 2 3 12 12 12 12 12 12 
0 0 0 0 0 0 0 0 0 0 0 0 0 0 0 0 0 0 0 0 0 0 0 3 3 3 3 3 0 0 0 0 0 0 0 0 0 0 0 0 3 3 2 3 3 12 12 12 12 12 12 12 12 12 12 12 12 12 12 12 12 12 12 12 12 14 2 2 2 2 2 2 13 12 12 12 12 12 12 12 12 12 12 12 12 12 12 12 12 3 2 2 2 3 12 12 12 12 12 12 
0 0 0 0 0 0 0 0 0 0 0 0 0 0 3 3 3 3 3 3 3 3 3 3 1 1 1 3 3 3 3 3 3 3 3 3 3 0 0 0 3 1 2 1 3 12 12 12 12 12 12 12 12 12 12 12 12 12 12 12 12 12 12 12 12 14 2 2 2 2 2 2 13 12 12 12 12 12 12 12 12 12 12 12 12 12 12 12 12 3 2 2 2 3 12 12 12 12 12 12 
0 0 0 0 0 0 0 0 0 0 0 0 0 0 3 1 1 1 1 1 1 1 1 1 18 18 18 1 1 1 1 1 1 1 1 1 3 0 0 0 3 6 2 5 3 12 12 12 12 12 12 12 12 12 12 12 12 12 12 12 12 12 12 12 12 14 2 2 2 2 2 2 13 12 12 12 12 12 12 12 12 12 12 12 12 12 12 12 12 3 3 2 3 3 12 12 12 12 12 12 
0 0 0 0 0 0 0 0 0 0 0 0 0 0 3 4 4 4 4 4 4 4 4 6 2 2 2 5 4 4 4 4 4 4 4 4 3 0 0 0 3 2 2 2 3 12 12 12 12 12 12 12 12 12 12 12 12 12 21 16 16 16 16 16 16 17 2 2 2 2 2 2 15 16 16 16 16 16 16 22 12 12 12 12 12 12 12 12 12 3 1 2 1 3 12 12 12 12 12 12 
0 0 0 0 0 0 0 0 0 0 0 0 0 0 3 2 2 2 2 2 2 2 2 2 2 2 2 2 2 2 2 2 2 2 2 2 3 0 0 0 3 2 2 2 3 12 12 12 12 12 12 12 12 12 12 12 12 12 14 2 2 2 2 2 2 2 2 2 2 2 2 2 2 2 2 2 2 2 2 13 12 12 12 12 12 12 12 12 12 3 6 2 5 3 12 12 12 12 12 12 
0 0 0 0 0 0 0 0 0 0 0 0 0 0 3 2 2 2 2 2 2 2 2 2 2 2 2 2 2 2 2 2 2 2 2 2 3 0 0 0 3 2 2 2 3 12 12 12 12 12 12 12 12 12 12 12 21 16 17 2 2 2 2 2 2 2 2 2 2 2 2 2 2 2 2 2 2 2 2 15 16 22 12 12 12 12 12 12 12 1 2 2 2 1 12 12 12 12 12 12 
0 0 0 0 0 0 0 0 0 0 0 0 0 0 3 2 2 2 2 2 2 2 2 2 2 2 2 2 2 2 2 2 2 2 2 2 3 0 0 0 3 2 2 2 3 12 12 12 12 12 12 12 12 12 12 12 14 2 2 2 2 2 2 2 2 2 2 2 2 2 2 2 2 2 2 2 2 2 2 2 2 13 12 12 12 12 12 12 12 11 2 2 2 9 12 12 12 12 12 12 
0 0 0 0 0 0 0 0 0 0 0 0 0 0 3 2 2 2 2 2 3 2 2 2 2 2 2 2 2 2 3 2 2 2 2 2 3 0 0 0 3 2 2 2 3 12 12 12 12 12 12 12 12 12 12 12 14 2 2 2 2 2 2 2 2 2 9 10 10 10 10 11 2 2 2 2 2 2 2 2 2 13 12 12 12 12 12 12 12 14 2 2 2 13 12 12 12 12 12 12 
0 0 0 0 0 0 0 0 3 3 3 3 3 3 3 2 2 2 2 2 3 2 2 2 2 2 2 2 2 2 3 2 2 2 2 2 3 3 3 3 3 2 2 2 3 3 3 3 3 3 3 3 3 3 3 3 3 2 2 2 2 2 2 2 2 9 20 21 16 16 22 19 11 2 2 2 2 2 2 2 2 13 12 12 12 12 12 12 12 14 2 2 2 13 12 12 12 12 12 12 
0 0 0 0 0 0 0 0 3 1 1 1 1 1 1 2 2 2 2 2 3 2 2 2 2 2 2 2 2 2 3 2 2 2 2 2 1 1 1 1 1 2 2 2 1 1 1 1 1 1 1 1 1 1 1 1 1 2 2 2 2 2 2 2 2 13 21 17 9 11 15 22 14 2 2 2 2 2 2 2 2 15 16 16 16 16 16 16 16 17 2 2 2 13 12 12 12 12 12 12 
0 0 0 0 0 0 0 0 3 4 4 4 4 4 6 2 2 2 2 2 3 2 2 2 2 2 2 2 2 2 3 2 2 2 2 2 5 4 4 4 6 2 2 2 5 4 4 4 4 4 4 4 4 4 4 4 6 2 2 2 2 2 2 2 2 13 14 9 12 12 11 13 14 2 2 2 2 2 2 2 2 2 2 2 2 2 2 2 2 2 2 2 2 13 12 12 12 12 12 12 
0 0 0 0 0 0 0 0 3 2 2 2 2 2 2 2 2 2 2 2 3 2 2 2 2 2 2 2 2 2 3 2 2 2 2 2 2 2 2 2 2 2 2 2 2 2 2 2 2 2 2 2 2 2 2 2 2 2 2 2 2 2 2 2 2 13 14 13 12 12 14 13 14 2 2 2 2 2 2 2 2 2 2 2 2 2 2 2 2 2 2 2 2 13 12 12 12 12 12 12 
0 0 0 0 0 0 0 0 3 2 2 2 2 2 2 2 2 2 2 2 3 2 2 2 2 2 2 2 2 2 3 2 2 2 2 2 2 2 2 2 2 2 2 2 2 2 2 2 2 2 2 2 2 2 2 2 2 2 2 2 2 2 2 2 2 13 14 15 12 12 17 13 14 2 2 2 2 2 2 2 2 2 2 2 2 2 2 2 2 2 2 2 2 13 12 12 12 12 12 12 
0 0 0 0 0 0 0 0 3 3 3 3 3 3 3 2 2 2 2 2 3 2 2 2 2 2 2 2 2 2 3 2 2 2 2 2 3 3 3 3 3 2 2 2 3 3 3 3 3 3 3 3 3 3 3 3 3 2 2 2 2 2 2 2 2 13 19 11 15 17 9 20 14 2 2 2 2 2 2 2 2 9 10 10 10 10 10 10 10 11 2 2 2 13 12 12 12 12 12 12 
0 0 0 0 0 0 0 0 0 0 0 0 0 0 3 2 2 2 2 2 3 2 2 2 2 2 2 2 2 2 3 2 2 2 2 2 3 1 1 1 3 2 2 2 3 1 1 1 1 1 1 1 1 1 1 1 1 2 2 2 2 2 2 2 2 15 22 19 10 10 20 21 17 2 2 2 2 2 2 2 2 13 12 12 12 12 12 12 12 14 2 2 2 13 12 12 12 12 12 12 
0 0 0 0 0 0 0 0 0 0 0 0 0 0 3 2 2 2 2 2 1 2 2 2 2 2 2 2 2 2 1 2 2 2 2 2 3 0 0 0 3 2 2 2 3 10 10 10 10 10 10 10 10 10 10 10 11 2 2 2 2 2 2 2 2 2 15 16 16 16 16 17 2 2 2 2 2 2 2 2 2 13 12 12 12 12 12 12 12 14 2 2 2 13 12 12 12 12 12 12 
0 0 0 0 0 0 0 0 0 0 0 0 0 0 3 2 2 2 2 2 4 2 2 2 2 2 2 2 2 2 4 2 2 2 2 2 3 0 0 0 3 3 3 3 3 12 12 12 12 12 12 12 12 12 12 12 14 2 2 2 2 2 2 2 2 2 2 2 2 2 2 2 2 2 2 2 2 2 2 2 2 13 12 12 12 12 12 12 12 14 2 2 2 13 12 12 12 12 12 12 
0 0 0 0 0 0 0 0 0 0 0 0 0 0 3 2 2 2 2 2 2 2 2 2 2 2 2 2 2 2 2 2 2 2 2 2 3 0 0 0 1 1 1 1 1 12 12 12 12 12 12 12 12 12 12 12 19 10 11 2 2 2 2 2 2 2 2 2 2 2 2 2 2 2 2 2 2 2 2 9 10 20 12 12 12 12 12 12 12 14 2 2 2 13 12 12 12 12 12 12 
0 0 0 0 0 0 0 0 0 0 0 0 0 0 3 2 2 2 2 2 2 2 2 2 2 2 2 2 2 2 2 2 2 2 2 2 3 0 0 0 0 0 0 0 0 12 12 12 12 12 12 12 12 12 12 12 12 12 14 2 2 2 2 2 2 2 2 2 2 2 2 2 2 2 2 2 2 2 2 13 12 12 12 12 12 12 12 12 12 14 2 2 2 13 12 12 12 12 12 12 
0 0 0 0 0 0 0 0 0 0 0 0 0 0 3 2 2 2 2 2 2 2 2 2 2 2 2 2 2 2 2 2 2 2 2 2 3 0 0 0 0 0 0 0 0 12 12 12 12 12 12 12 12 12 12 12 12 12 19 10 10 10 10 10 10 10 10 10 10 10 10 10 10 10 10 10 10 10 10 20 12 12 12 12 12 12 12 12 12 14 2 2 2 13 12 12 12 12 12 12 
0 0 0 0 0 0 0 0 0 0 0 0 0 0 3 3 3 3 3 3 3 3 3 3 2 2 2 3 3 3 3 3 3 3 3 3 3 0 0 0 3 3 3 3 3 12 12 12 12 12 12 12 12 12 12 12 12 12 12 12 12 12 12 12 12 12 12 12 12 12 12 12 12 12 12 12 12 12 12 12 12 12 12 12 12 12 12 12 12 14 2 2 2 13 12 12 12 12 12 12 
0 0 0 0 0 0 0 0 0 0 0 0 0 0 1 1 1 1 1 1 1 1 1 3 2 2 2 3 1 1 1 1 1 1 1 1 1 0 0 0 3 1 1 1 3 12 12 12 12 12 12 12 12 12 12 12 12 12 12 12 12 12 12 12 12 12 12 12 12 12 12 12 12 12 12 12 12 12 12 12 12 12 12 12 12 12 12 12 12 14 2 2 2 13 12 12 12 12 12 12 
0 0 0 0 0 0 0 0 0 0 0 0 0 0 0 0 0 0 0 0 0 0 0 3 2 2 2 3 0 0 0 0 0 0 0 0 0 3 3 3 3 2 2 2 3 3 3 3 12 12 12 12 12 12 12 12 12 12 12 12 12 12 12 12 12 12 12 12 12 12 12 12 12 12 12 12 12 12 12 12 12 12 12 12 12 12 12 12 12 14 2 2 2 13 12 12 12 12 12 12 
0 0 0 0 0 0 0 0 0 0 0 0 0 0 0 0 0 0 0 0 0 0 0 3 2 2 2 3 0 0 0 0 0 0 0 0 0 3 1 1 1 18 18 18 1 1 1 3 12 12 12 12 12 12 12 12 12 12 12 12 12 12 12 12 12 12 12 12 12 12 12 12 12 12 12 12 12 12 12 12 12 12 12 12 12 12 12 12 12 14 2 2 2 13 12 12 12 12 12 12 
0 0 0 0 0 0 0 0 0 0 0 0 0 0 0 0 0 0 0 0 0 0 0 3 2 2 2 3 0 0 0 0 0 0 0 0 0 3 4 4 6 2 2 2 5 4 4 3 12 12 12 12 12 12 12 12 12 12 12 12 12 12 12 12 12 12 12 12 12 12 12 12 12 12 12 12 12 12 12 12 12 12 12 12 12 12 12 12 12 14 2 2 2 13 12 12 12 12 12 12 
0 0 0 0 0 0 0 0 0 0 0 0 0 0 0 0 0 0 0 0 0 0 0 3 2 2 2 3 0 0 0 0 0 0 0 0 0 3 2 2 2 2 2 2 2 2 2 3 12 12 12 12 12 12 12 12 12 12 12 12 12 12 12 12 12 12 12 12 12 12 12 12 12 12 12 12 12 12 12 12 12 12 12 12 12 12 12 12 12 14 2 2 2 13 12 12 12 12 12 12 
0 0 0 0 0 0 0 0 0 0 0 0 0 0 0 0 0 0 0 0 0 0 0 3 3 3 3 3 0 0 0 0 0 0 0 0 0 3 2 2 2 2 2 2 2 2 2 3 12 12 12 12 12 12 12 12 12 12 12 12 12 12 12 12 12 12 12 12 12 12 12 12 12 12 12 12 12 12 12 12 12 12 12 12 12 12 12 12 12 14 2 2 2 13 12 12 12 12 12 12 
0 0 0 0 0 0 0 0 0 0 0 0 0 0 0 0 0 0 0 0 0 0 0 1 1 1 1 1 0 0 0 0 0 0 0 0 0 3 2 2 2 2 2 2 2 2 2 3 12 12 12 12 12 12 12 12 12 12 12 12 12 12 12 12 12 12 12 12 12 12 12 12 12 12 12 12 12 12 12 12 12 12 12 12 12 12 12 12 21 3 2 2 2 3 22 12 12 12 12 12 
0 0 0 0 0 0 0 0 0 0 0 0 0 0 0 0 0 0 0 0 0 0 0 0 0 0 0 0 0 0 0 0 0 0 0 0 0 3 2 2 2 2 2 2 2 2 2 3 12 12 12 12 12 12 12 12 12 12 12 12 12 12 12 12 12 12 12 12 12 12 12 12 12 12 12 12 12 12 12 12 12 12 12 12 12 12 12 12 14 3 3 2 3 3 13 12 12 12 12 12 
0 0 0 0 0 0 0 0 0 0 0 0 0 0 0 0 0 0 0 0 0 0 0 0 0 0 0 0 0 0 0 0 0 0 0 0 0 3 2 2 2 2 2 2 2 2 2 3 12 12 12 12 12 12 12 12 12 12 12 12 12 12 12 12 12 12 12 12 12 12 12 12 12 12 12 12 12 12 12 12 12 12 12 12 12 12 12 12 14 3 1 2 1 3 13 12 12 12 12 12 
0 0 0 0 0 0 0 0 0 0 0 0 0 0 0 0 0 0 0 0 0 0 0 0 0 0 0 0 0 0 0 0 0 0 0 0 0 3 2 2 2 2 2 2 2 2 2 3 12 12 12 12 12 12 12 12 12 12 12 12 12 12 12 12 12 12 12 12 12 12 12 12 12 12 12 12 12 12 12 12 12 12 12 12 12 12 12 12 14 1 6 2 5 1 13 12 12 12 12 12 
0 0 0 0 0 0 0 0 0 0 0 0 0 0 0 0 0 0 0 0 0 0 0 0 0 0 0 0 0 0 0 0 0 0 0 0 0 3 2 2 2 2 2 2 2 2 2 3 12 12 12 12 12 12 12 12 12 12 12 12 12 12 12 12 12 12 12 12 12 12 12 12 12 12 12 12 12 12 12 12 12 12 12 12 12 12 12 12 19 11 2 2 2 9 20 12 12 12 12 12 
0 0 0 0 0 0 0 0 0 0 0 0 0 0 0 0 0 0 0 0 0 0 0 3 3 3 3 3 0 0 0 0 0 0 0 0 0 3 2 2 2 2 2 2 2 2 2 3 12 12 12 12 12 12 12 12 12 12 12 12 12 12 12 12 12 12 12 12 12 12 12 12 12 12 12 12 12 12 12 12 12 12 12 12 12 12 12 12 12 14 2 2 2 13 12 12 12 12 12 12 
0 0 0 0 0 0 0 0 0 0 0 0 0 0 0 0 0 0 0 0 0 0 0 3 1 1 1 3 0 0 0 0 0 0 0 0 0 3 3 3 3 2 2 2 3 3 3 3 12 12 12 12 12 12 12 12 12 12 12 12 12 12 3 3 3 3 3 3 3 3 22 12 12 12 12 12 12 12 12 12 12 12 12 12 12 12 12 12 12 14 2 2 2 13 12 12 12 12 12 12 
0 0 0 0 0 0 0 0 0 0 0 0 0 0 0 0 0 0 0 0 0 0 0 3 4 4 4 3 0 0 0 0 0 0 0 0 0 1 1 1 3 2 2 2 3 1 1 1 12 12 12 12 12 12 12 12 12 12 12 12 12 12 3 1 1 1 1 1 1 1 15 16 16 16 16 16 16 22 12 12 12 12 12 12 12 12 12 12 12 14 2 2 2 13 12 12 12 12 12 12 
0 0 0 0 0 0 0 0 0 0 0 0 0 0 0 0 0 0 0 0 0 0 0 3 2 2 2 3 0 0 0 0 0 0 0 0 0 0 0 0 3 2 2 2 3 10 10 10 12 12 12 12 12 12 12 12 12 12 12 12 12 12 3 4 4 4 4 4 4 6 2 2 2 2 2 2 2 13 12 12 12 12 12 12 12 12 12 12 12 14 2 2 2 13 12 12 12 12 12 12 
0 0 0 0 0 0 0 0 0 0 0 0 0 0 0 0 0 0 0 0 0 0 0 3 2 2 2 3 0 0 0 0 0 0 0 0 0 0 0 0 3 2 2 2 3 12 12 12 12 12 12 12 12 12 12 12 12 12 12 12 12 12 3 2 2 2 2 2 2 2 2 2 2 2 2 2 2 13 12 12 12 12 12 12 12 12 12 12 12 14 2 2 2 13 12 12 12 12 12 12 
0 0 0 0 0 0 0 0 0 0 0 0 0 0 0 0 0 0 0 0 0 0 0 3 3 2 3 3 0 0 0 0 0 0 0 0 0 0 0 0 3 2 2 2 3 12 12 12 12 12 12 12 12 12 12 12 12 12 12 12 12 12 3 2 2 2 3 3 2 2 2 3 3 2 2 2 2 13 12 12 12 12 12 12 12 12 12 12 12 14 2 2 2 13 12 12 12 12 12 12 
0 0 0 0 0 0 0 0 0 0 0 0 0 0 3 3 3 3 3 3 3 3 3 3 1 2 1 3 3 3 3 3 3 3 3 3 3 0 0 0 3 2 2 2 3 3 3 3 3 3 3 3 3 3 3 3 3 3 3 3 3 3 3 2 2 2 3 3 2 2 2 3 3 2 2 2 2 13 12 12 12 12 12 12 12 12 12 12 12 14 2 2 2 13 12 12 12 12 12 12 
0 0 0 0 0 0 0 0 0 0 0 0 0 0 3 1 1 1 1 1 1 1 1 1 6 2 5 1 1 1 1 1 1 1 1 1 3 0 0 0 3 2 2 2 1 1 1 1 1 1 1 1 1 1 1 1 1 1 1 1 1 1 1 2 2 2 1 1 2 2 2 1 1 2 2 2 2 15 16 16 16 16 16 16 16 16 16 16 16 17 2 2 2 13 12 12 12 12 12 12 
0 0 0 0 0 0 0 0 0 0 0 0 0 0 3 4 4 4 4 4 4 4 4 6 2 2 2 5 4 4 4 4 4 4 4 4 3 0 0 0 3 2 2 2 5 4 4 4 4 4 4 4 4 4 4 4 4 4 4 4 4 4 6 2 2 2 5 6 2 2 2 5 6 2 2 2 2 2 2 2 2 2 2 2 2 2 2 2 2 2 2 2 2 13 12 12 12 12 12 12 
0 0 0 0 0 0 0 0 0 0 0 0 0 0 3 2 2 2 2 2 2 2 2 2 2 2 2 2 2 2 2 2 2 2 2 2 3 0 0 0 3 2 2 2 2 2 2 2 2 2 2 2 2 2 2 2 2 2 2 2 2 2 2 2 2 2 2 2 2 2 2 2 2 2 2 2 2 2 2 2 2 2 2 2 2 2 2 2 2 2 2 2 2 13 12 12 12 12 12 12 
0 0 0 0 0 0 0 0 0 0 0 0 0 0 3 2 2 2 2 2 2 2 2 2 2 2 2 2 2 2 2 2 2 2 2 2 3 0 0 0 3 2 2 2 2 2 2 2 2 2 2 2 2 2 2 2 2 2 2 2 2 2 2 2 2 2 2 2 2 2 2 2 2 2 2 2 2 2 2 2 2 2 2 2 2 2 2 2 2 2 2 2 2 13 12 12 12 12 12 12 
0 0 0 0 0 0 0 0 0 0 0 0 0 0 3 2 2 2 2 2 2 2 2 2 2 2 2 2 2 2 2 2 2 2 2 2 3 0 0 0 3 2 2 2 3 3 3 3 3 3 3 3 3 3 3 3 3 3 3 3 3 3 3 2 2 2 3 3 2 2 2 3 3 2 2 2 2 9 10 10 10 10 10 10 10 10 10 10 10 10 10 10 10 20 12 12 12 12 12 12 
0 0 0 0 0 0 0 0 0 0 0 0 0 0 3 2 2 2 2 2 2 2 2 2 2 2 2 2 2 2 2 2 2 2 2 2 3 0 0 0 3 3 2 3 3 1 1 1 1 1 1 1 1 1 1 1 1 1 1 1 1 1 3 2 2 2 3 3 2 2 2 3 3 2 2 2 2 13 12 12 12 12 12 12 12 12 12 12 12 12 12 12 12 12 12 12 12 12 12 12 
0 0 0 0 0 0 0 0 0 0 0 0 0 0 3 2 2 2 2 2 2 3 3 3 3 3 3 3 3 3 2 2 2 2 2 2 3 0 0 0 3 1 2 1 3 10 10 10 10 10 10 10 10 10 10 10 10 10 10 10 10 10 3 2 2 2 1 1 2 2 2 1 1 2 2 2 2 13 12 12 12 12 12 12 12 12 12 12 12 12 12 12 12 12 12 12 12 12 12 12 
0 0 0 0 0 0 0 0 0 0 0 0 0 0 3 2 2 2 2 2 2 3 3 3 3 3 3 3 3 3 2 2 2 2 2 2 3 3 3 3 3 6 2 5 3 12 12 12 12 12 12 12 12 12 12 12 12 12 12 12 12 12 3 2 2 2 5 6 2 2 2 5 6 2 2 2 2 13 12 12 12 12 12 12 12 12 12 12 12 12 12 12 12 12 12 12 12 12 12 12 
0 0 0 0 0 0 0 0 0 0 0 0 0 0 3 2 2 2 2 2 2 3 3 3 3 3 3 3 3 3 2 2 2 2 2 2 1 1 1 1 1 2 2 2 3 12 12 12 12 12 12 12 12 12 12 12 12 12 12 12 12 12 3 2 2 2 2 2 2 2 2 2 2 2 2 2 2 13 12 12 12 12 12 12 12 12 12 12 12 12 12 12 12 12 12 12 12 12 12 12 
0 0 0 0 0 0 0 0 0 0 0 0 0 0 3 2 2 2 2 2 2 3 3 3 3 3 3 3 3 3 2 2 2 2 2 2 5 4 4 4 6 2 2 2 3 12 12 12 12 12 12 12 12 12 12 12 12 12 12 12 12 12 3 3 3 3 3 3 3 3 3 3 9 10 10 10 10 20 12 12 12 12 12 12 12 12 12 12 12 12 12 12 12 12 12 12 12 12 12 12 
0 0 0 0 0 0 0 0 0 0 0 0 0 0 3 2 2 2 2 2 2 3 3 3 3 3 3 3 3 3 2 2 2 2 2 2 2 2 2 2 2 2 2 2 3 12 12 12 12 12 12 12 12 12 12 12 12 12 12 12 12 12 1 1 1 1 1 1 1 1 1 1 13 12 12 12 12 12 12 12 12 12 12 12 12 12 12 12 12 12 12 12 12 12 12 12 12 12 12 12 
0 0 0 0 0 0 0 0 0 0 0 0 0 0 3 2 2 2 2 2 2 3 3 3 3 3 3 3 3 3 2 2 2 2 2 2 2 2 2 2 2 2 2 2 3 12 12 12 12 12 12 12 12 12 12 12 12 12 12 12 12 12 10 10 10 10 10 10 10 10 10 10 20 12 12 12 12 12 12 12 12 12 12 12 12 12 12 12 12 12 12 12 12 12 12 12 12 12 12 12 
0 0 0 0 0 0 0 0 0 0 0 0 0 0 3 2 2 2 2 2 2 3 3 3 3 3 3 3 3 3 2 2 2 2 2 2 3 3 3 3 3 3 3 3 3 12 12 12 12 12 12 12 12 12 12 12 12 12 12 12 12 12 12 12 12 12 12 12 12 12 12 12 12 12 12 12 12 12 12 12 12 12 12 12 12 12 12 12 12 12 12 12 12 12 12 12 12 12 12 12 
0 0 0 0 0 0 0 0 0 0 0 0 0 0 3 2 2 2 2 2 2 3 3 3 3 3 3 3 3 3 2 2 2 2 2 2 3 1 1 1 1 1 1 1 1 12 12 12 12 12 12 12 12 12 12 12 12 12 12 12 12 12 12 12 12 12 12 12 12 12 12 12 12 12 12 12 12 12 12 12 12 12 12 12 12 12 12 12 12 12 12 12 12 12 12 12 12 12 12 12 
0 0 0 0 0 0 0 0 0 0 0 0 0 0 3 2 2 2 2 2 2 1 1 1 1 1 1 1 1 1 2 2 2 2 2 2 3 10 10 10 10 10 10 10 10 12 12 12 12 12 12 12 12 12 12 12 12 12 12 12 12 12 12 12 12 12 12 12 12 12 12 12 12 12 12 12 12 12 12 12 12 12 12 12 12 12 12 12 12 12 12 12 12 12 12 12 12 12 12 12 
0 0 0 0 0 0 0 0 0 0 0 0 0 0 3 2 2 2 2 2 2 5 4 4 4 4 4 4 4 6 2 2 2 2 2 2 3 12 12 12 12 12 12 12 12 12 12 12 12 12 12 12 12 12 12 12 12 12 12 12 12 12 12 12 12 12 12 12 12 12 12 12 12 12 12 12 12 12 12 12 12 12 12 12 12 12 12 12 12 12 12 12 12 12 12 12 12 12 12 12 
0 0 0 0 0 0 0 0 0 0 0 0 0 0 3 2 2 2 2 2 2 2 2 2 2 2 2 2 2 2 2 2 2 2 2 2 3 12 12 12 12 12 12 12 12 12 12 12 12 12 12 12 12 12 12 12 12 12 12 12 12 12 12 12 12 12 12 12 12 12 12 12 12 12 12 12 12 12 12 12 12 12 12 12 12 12 12 12 12 12 12 12 12 12 12 12 12 12 12 12 
0 0 0 0 0 0 0 0 0 0 0 0 0 0 3 2 2 2 2 2 2 2 2 2 2 2 2 2 2 2 2 2 2 2 2 2 3 12 12 12 12 12 12 12 12 12 12 12 12 12 12 12 12 12 12 12 12 12 12 12 12 12 12 12 12 12 12 12 12 12 12 12 12 12 12 12 12 12 12 12 12 12 12 12 12 12 12 12 12 12 12 12 12 12 12 12 12 12 12 12 
0 0 0 0 0 0 0 0 0 0 0 0 0 0 3 2 2 2 2 2 2 2 2 2 2 2 2 2 2 2 2 2 2 2 2 2 3 12 12 12 12 12 12 12 12 12 12 12 12 12 12 12 12 12 21 3 3 3 3 3 3 22 12 12 12 12 12 12 12 12 12 12 12 12 12 12 12 12 12 12 12 12 12 12 12 12 12 12 12 12 12 12 12 12 12 12 12 12 12 12 
0 0 0 0 0 0 0 0 0 0 0 0 0 0 3 3 3 3 3 3 3 3 3 3 2 2 2 3 3 3 3 3 3 3 3 3 3 12 12 12 12 12 12 12 12 12 12 12 12 21 16 16 16 16 17 1 1 1 1 1 1 15 16 16 16 16 16 16 16 16 16 16 16 16 16 16 16 16 16 16 16 16 22 12 12 12 12 12 12 12 12 12 12 12 12 12 12 12 12 12 
0 0 0 0 0 0 0 0 0 0 0 0 0 0 1 1 1 1 1 1 1 1 1 3 2 2 2 3 1 1 1 1 1 1 1 1 1 12 12 12 12 12 12 12 12 12 12 12 12 17 2 2 2 2 2 5 4 4 4 4 6 2 2 2 2 2 2 2 2 2 2 2 2 2 2 2 2 2 2 2 2 2 15 12 12 12 12 12 12 12 12 12 12 12 12 12 12 12 12 12 
0 0 0 0 0 0 0 0 0 0 0 0 0 0 0 0 0 0 0 0 0 0 0 3 2 2 2 3 10 10 10 10 10 10 10 10 10 12 12 12 12 12 12 12 12 12 12 21 17 2 2 2 2 2 2 2 2 2 2 2 2 2 2 2 2 2 2 2 2 2 2 2 2 2 2 2 2 2 2 2 2 2 2 15 22 12 12 12 12 12 12 3 3 3 12 12 12 12 12 12 
0 0 0 0 0 0 0 0 0 0 0 0 0 0 0 0 0 0 0 0 0 0 0 3 2 2 2 3 12 12 12 12 12 12 12 12 12 12 12 12 12 12 12 12 12 12 12 14 2 2 2 2 2 2 2 2 2 2 2 2 2 2 2 2 2 2 2 2 2 2 2 3 2 2 2 2 2 2 2 2 2 2 2 2 15 22 12 12 12 12 3 1 1 1 3 12 12 12 12 12 
0 0 0 0 0 0 0 0 0 0 0 0 0 0 0 0 0 0 0 0 0 0 0 3 2 2 2 3 12 12 12 12 12 12 12 12 12 12 12 12 12 12 12 12 12 12 12 14 2 2 2 2 2 2 2 2 2 2 2 2 2 2 2 2 2 2 2 2 2 3 3 3 2 2 2 2 2 2 2 2 2 2 2 2 3 13 12 12 12 3 1 2 2 2 1 3 12 12 12 12 
0 0 0 0 0 0 0 0 0 0 0 0 0 0 0 0 0 0 0 0 0 0 0 3 3 2 3 3 12 12 12 12 12 12 12 12 12 12 12 12 12 12 12 12 12 12 12 14 2 2 2 2 2 2 2 2 2 2 2 2 2 2 2 2 2 2 2 3 3 3 3 3 2 2 2 2 2 2 2 2 2 2 2 2 3 13 12 12 12 3 2 2 2 2 2 3 12 12 12 12 
0 0 0 0 0 0 0 0 0 0 0 0 0 0 0 0 0 0 0 0 0 0 0 3 1 2 1 3 12 12 12 12 12 12 12 12 12 12 12 12 12 12 12 12 12 12 12 14 2 2 2 2 2 2 2 2 2 2 2 2 2 2 2 2 2 2 2 3 3 3 3 1 2 2 9 10 10 10 10 11 2 2 2 2 3 13 12 12 12 3 2 2 2 2 2 3 12 12 12 12 
0 0 0 0 0 0 0 0 0 0 0 0 0 0 0 0 0 0 0 0 0 0 0 3 6 2 5 3 12 12 12 12 12 12 12 12 12 12 12 12 12 12 12 12 12 12 12 14 2 2 2 2 2 2 2 2 2 2 2 2 2 2 2 2 2 2 3 3 3 3 1 6 2 2 13 12 12 12 12 14 2 2 2 2 3 13 12 12 12 3 2 2 2 2 2 3 12 12 12 12 
0 0 0 0 0 0 0 0 0 0 0 0 0 0 0 0 0 0 0 0 0 0 0 3 2 2 2 3 3 3 3 3 12 12 12 12 12 12 12 12 21 3 3 3 22 12 12 14 2 2 2 2 2 2 2 2 2 2 2 2 2 2 2 2 2 2 3 3 3 3 6 2 2 2 13 12 21 22 12 14 2 2 2 2 3 13 12 12 12 1 3 3 2 3 3 1 12 12 12 12 
0 0 0 0 0 0 0 0 0 0 0 0 0 0 0 0 0 0 0 0 0 0 0 3 2 2 2 1 1 1 1 1 15 16 16 16 16 16 16 16 17 1 1 1 15 16 16 17 2 2 2 2 2 2 2 2 2 2 2 2 2 2 2 2 2 2 3 3 3 3 2 2 2 2 13 12 19 20 12 14 2 2 2 2 3 3 3 3 3 3 3 1 2 1 3 10 12 12 12 12 
0 0 0 0 0 0 0 0 0 0 0 0 0 0 0 0 0 0 0 0 0 0 0 3 2 2 2 5 4 4 4 6 2 2 2 2 2 2 2 2 2 5 4 6 2 2 2 2 2 2 2 2 2 2 2 2 2 2 2 2 2 2 2 2 2 2 3 3 3 3 2 2 2 2 13 12 12 12 12 14 2 2 2 2 1 1 1 1 1 1 1 6 2 5 3 12 12 12 12 12 
0 0 0 0 0 0 0 0 0 0 0 0 0 0 0 0 0 0 0 0 0 0 0 3 2 2 2 2 2 2 2 2 2 2 2 2 2 2 2 2 2 2 2 2 2 2 2 2 2 2 2 2 2 2 2 2 2 2 2 2 2 2 2 2 2 2 1 3 3 3 3 2 2 2 15 16 16 16 16 17 2 2 2 2 5 4 4 4 4 4 6 2 2 2 3 12 12 12 12 12 
0 0 0 0 0 0 0 0 0 0 0 0 0 0 0 0 0 0 0 0 0 0 0 3 2 2 2 2 2 2 2 2 2 2 2 2 2 2 2 2 2 2 2 2 2 2 2 2 2 2 2 2 2 2 2 2 2 2 2 2 2 2 2 2 2 2 5 1 3 3 3 2 2 2 2 2 2 2 2 2 2 2 2 2 2 2 2 2 2 2 2 2 2 2 3 12 12 12 12 12 
0 0 0 0 0 0 0 0 0 0 0 0 0 0 0 0 0 0 0 0 0 0 0 3 3 3 3 3 3 3 3 3 3 3 3 3 3 3 3 3 3 3 3 3 3 3 3 3 2 2 2 2 2 2 2 2 2 2 2 2 2 2 2 2 2 2 2 5 1 3 3 3 2 2 2 2 2 2 2 2 2 2 2 2 2 2 2 2 2 2 2 2 2 2 3 12 12 12 12 12 
0 0 0 0 0 0 0 0 0 0 0 0 0 0 0 0 0 0 0 0 0 0 0 1 1 1 1 1 1 1 1 1 1 1 1 1 1 1 1 1 1 1 1 1 1 1 1 3 2 2 2 2 2 2 2 2 2 2 2 2 2 2 2 2 2 2 2 2 5 1 1 1 2 2 2 2 2 9 10 11 2 2 2 2 3 3 3 3 3 3 3 3 3 3 3 12 12 12 12 12 
0 0 0 0 0 0 0 0 0 0 0 0 0 0 0 0 0 0 0 0 0 0 0 0 0 0 0 0 0 0 0 0 0 0 0 0 0 0 0 0 0 0 0 0 0 0 0 3 2 2 2 2 2 2 2 2 2 2 2 2 2 2 2 2 2 2 2 2 2 5 4 6 2 2 2 2 2 13 12 14 2 2 2 2 3 1 1 1 1 1 1 1 1 1 1 12 12 12 12 12 
0 0 0 0 0 0 0 0 0 0 0 0 0 0 0 0 0 0 0 0 0 0 0 0 0 0 0 0 0 0 0 0 0 0 0 0 0 0 0 0 0 0 0 0 0 0 0 3 2 2 2 2 2 2 2 2 2 2 2 2 2 2 2 2 2 2 2 2 2 2 2 2 2 2 2 2 2 15 22 19 10 11 2 2 3 9 10 10 10 10 10 10 10 10 10 12 12 12 12 12 
0 0 0 0 0 0 0 0 0 0 0 0 0 0 0 0 0 0 0 0 0 0 0 0 0 0 0 0 0 0 0 0 0 0 0 0 0 0 0 0 0 0 0 0 0 0 0 3 2 2 2 2 2 2 2 2 2 2 2 2 2 2 2 2 2 2 2 2 2 2 2 2 2 2 2 2 2 2 15 16 16 19 10 10 3 13 12 12 12 12 12 12 12 12 12 12 12 12 12 12 
0 0 0 0 0 0 0 0 0 0 0 0 0 0 0 0 0 0 0 0 0 0 0 0 0 0 0 0 0 0 0 0 0 0 0 0 0 0 0 0 0 0 0 0 0 0 0 3 3 3 3 3 3 3 3 3 3 3 3 3 3 3 3 3 3 3 3 3 3 3 3 3 3 3 3 3 3 3 3 3 3 3 3 3 3 13 12 12 12 12 12 12 12 12 12 12 12 12 12 12 
0 0 0 0 0 0 0 0 0 0 0 0 0 0 0 0 0 0 0 0 0 0 0 0 0 0 0 0 0 0 0 0 0 0 0 0 0 0 0 0 0 0 0 0 0 0 0 1 1 1 1 1 1 1 1 1 1 1 1 1 1 1 1 1 1 1 1 1 1 1 1 1 1 1 1 1 1 1 1 1 1 1 1 1 1 13 12 12 12 12 12 12 12 12 12 12 12 12 12 12 
0 0 0 0 0 0 0 0 0 0 0 0 0 0 0 0 0 0 0 0 0 0 0 0 0 0 0 0 0 0 0 0 0 0 0 0 0 0 0 0 0 0 0 0 0 0 0 0 0 0 0 0 0 0 0 0 0 0 0 0 0 0 0 0 0 9 10 10 10 10 10 10 10 10 10 10 10 10 10 10 10 10 10 10 10 12 12 12 12 12 12 12 12 12 12 12 12 12 12 12 
0 0 0 0 0 0 0 0 0 0 0 0 0 0 0 0 0 0 0 0 0 0 0 0 0 0 0 0 0 0 0 0 0 0 0 0 0 0 0 0 0 0 0 0 0 0 0 0 0 0 0 0 0 0 0 0 0 0 0 0 0 0 0 0 0 13 12 12 12 12 12 12 12 12 12 12 12 12 12 12 12 12 12 12 12 12 12 12 12 12 12 12 12 12 12 12 12 12 12 12 
