0 0 0 0 0 0 0 0 0 0 0 0 0 0 0 0 0 0 0 0 0 0 0 0 0 0 0 0 0 0 0 0 0 0 0 0 0 0 0 0 0 0 0 0 0 0 0 0 0 0
0 0 0 0 0 0 0 0 0 0 0 0 0 0 0 0 0 3 3 3 3 3 3 3 3 3 3 3 3 3 3 3 3 0 0 0 0 0 0 0 0 0 0 0 0 0 0 0 0 0
0 0 0 0 0 0 0 0 0 0 0 0 0 0 0 0 0 3 1 1 1 1 1 1 1 1 1 1 1 1 1 1 3 0 0 0 0 0 0 0 0 0 0 0 0 0 0 0 0 0 
0 0 0 0 0 0 0 0 0 0 0 0 0 0 0 0 0 3 4 4 4 4 4 4 4 4 4 4 4 4 4 4 3 0 0 0 0 3 3 3 3 3 3 3 3 3 3 3 0 0 
0 0 3 3 3 3 3 3 3 3 3 0 0 0 0 0 0 3 2 2 2 2 2 2 2 2 2 2 2 2 2 2 3 0 0 0 0 3 1 1 1 1 1 1 1 1 1 3 0 0 
0 0 3 1 1 1 1 1 1 1 3 0 0 0 0 0 0 3 2 2 2 2 2 2 2 2 2 2 2 2 2 2 3 0 0 0 0 3 4 4 4 4 4 4 4 4 4 3 0 0 
0 0 3 4 4 4 4 4 4 4 3 3 3 3 3 3 3 3 2 2 2 2 2 2 2 2 2 2 2 2 2 2 3 3 3 3 3 3 2 2 2 2 2 2 2 2 2 3 0 0 
0 0 3 2 2 2 2 2 2 2 1 1 1 1 1 1 1 1 2 2 2 2 2 2 2 2 2 2 2 2 2 2 1 1 1 1 1 1 2 2 2 2 2 2 2 2 2 3 0 0 
0 0 3 2 2 2 2 2 2 2 5 4 4 4 4 4 4 6 2 2 2 2 2 2 3 3 3 2 2 2 2 2 5 4 4 4 4 6 2 2 2 9 10 11 2 2 2 3 0 0 
0 0 3 2 2 2 2 2 2 2 2 2 2 2 2 2 2 2 2 2 2 2 2 2 3 3 3 2 2 2 2 2 2 2 2 2 2 2 2 2 2 13 12 14 2 2 2 3 0 0 
0 0 3 2 2 2 2 2 2 2 2 2 2 2 2 2 2 2 2 2 2 2 2 2 3 3 3 2 2 2 2 2 2 2 2 2 2 2 2 2 2 15 16 17 2 2 2 3 0 0 
0 0 3 2 2 2 2 2 2 2 3 3 3 3 3 3 3 3 2 2 2 2 2 2 1 1 1 2 2 2 2 2 3 3 3 3 3 3 2 2 2 2 2 2 2 2 2 3 0 0 
0 0 3 2 2 2 2 2 2 2 3 1 1 1 1 1 1 3 2 2 2 2 2 2 5 4 6 2 2 2 2 2 3 1 1 1 1 3 2 2 2 2 2 2 2 2 2 3 0 0 
0 0 3 3 3 3 3 3 3 3 3 0 0 0 0 0 0 3 2 2 2 2 2 2 2 2 2 2 2 2 2 2 3 0 0 0 0 3 2 2 2 2 2 2 2 2 2 3 0 0 
0 0 1 1 1 1 1 1 1 1 1 0 0 0 0 0 0 3 2 2 2 2 2 2 2 2 2 2 2 2 2 2 3 0 0 0 0 3 3 3 3 18 18 18 3 3 3 3 0 0 
0 0 0 0 0 0 0 0 0 0 0 0 0 0 0 0 0 3 2 2 2 2 2 2 2 2 2 2 2 2 2 2 3 0 0 0 0 1 1 1 3 2 2 2 3 1 1 1 0 0 
0 0 0 0 0 0 0 0 0 0 0 0 0 0 0 0 0 3 3 3 3 3 3 3 18 18 18 3 3 3 3 3 3 0 0 0 0 0 0 0 3 2 2 2 3 0 0 0 0 0 
0 0 0 0 0 0 0 0 0 0 0 0 0 0 0 0 0 1 1 1 1 1 1 3 2 2 2 3 1 1 1 1 1 0 0 0 0 0 0 0 3 2 2 2 3 0 0 0 0 0 
0 0 0 0 0 0 0 0 0 0 0 0 0 0 0 0 0 0 0 0 0 0 0 3 2 2 2 3 0 0 0 0 0 0 0 0 0 0 0 0 3 2 2 2 3 0 0 0 0 0 
0 0 0 0 0 0 0 0 0 0 0 0 0 0 0 0 0 0 0 0 0 0 0 3 2 2 2 3 0 0 0 0 0 0 0 0 0 0 0 0 3 2 2 2 3 0 0 0 0 0 
0 0 0 0 0 0 0 0 0 0 0 0 0 0 0 0 0 0 0 0 0 0 0 3 2 2 2 3 0 0 0 0 0 0 0 0 0 0 0 0 3 2 2 2 3 0 0 0 0 0 
0 0 0 0 0 0 0 0 0 0 0 0 0 0 3 3 3 3 3 3 3 3 3 3 18 18 18 3 3 3 3 3 3 3 3 3 3 0 0 0 3 2 2 2 3 0 0 0 0 0 
0 0 0 0 0 0 0 0 0 0 0 0 0 0 3 1 1 1 1 1 1 1 1 1 2 2 2 1 1 1 1 1 1 1 1 1 3 0 0 0 3 2 2 2 3 0 0 0 0 0 
0 0 0 0 0 0 0 0 0 0 0 0 0 0 3 4 4 4 4 4 4 4 4 6 2 2 2 5 4 4 4 4 4 4 4 4 3 0 0 0 3 2 2 2 3 0 0 0 0 0 
0 0 0 0 0 0 0 0 0 0 0 0 0 0 3 2 2 2 2 2 2 2 2 2 2 2 2 2 2 2 2 2 2 2 2 2 3 0 0 0 3 2 2 2 3 0 0 0 0 0 
0 3 3 3 3 3 3 3 3 3 3 3 0 0 3 2 2 2 2 2 2 2 2 2 2 2 2 2 2 2 2 2 2 2 2 2 3 0 0 0 3 2 2 2 3 0 0 0 0 0 
0 3 1 1 1 1 1 1 1 1 1 3 0 0 3 2 2 2 2 2 2 2 2 2 2 2 2 2 2 2 2 2 2 2 2 2 3 0 0 0 3 2 2 2 3 0 0 0 0 0 
0 3 4 4 4 4 4 4 4 4 4 3 0 0 3 2 2 2 2 2 3 2 2 2 2 2 2 2 2 2 3 2 2 2 2 2 3 0 0 0 3 2 2 2 3 0 0 0 0 0 
0 3 2 2 2 2 2 2 2 2 2 3 3 3 3 2 2 2 2 2 3 2 2 2 2 2 2 2 2 2 3 2 2 2 2 2 3 3 3 3 3 2 2 2 3 0 0 0 0 0 
0 3 2 2 2 2 2 2 2 2 2 1 1 1 1 2 2 2 2 2 3 2 2 2 2 2 2 2 2 2 3 2 2 2 2 2 1 1 1 1 1 2 2 2 3 0 0 0 0 0 
0 3 2 2 2 2 2 2 2 2 2 5 4 4 6 2 2 2 2 2 3 2 2 2 2 2 2 2 2 2 3 2 2 2 2 2 5 4 4 4 6 2 2 2 3 0 0 0 0 0 
0 3 2 2 2 2 2 2 2 2 2 2 2 2 2 2 2 2 2 2 3 2 2 2 2 2 2 2 2 2 3 2 2 2 2 2 2 2 2 2 2 2 2 2 3 0 0 0 0 0 
0 3 2 2 2 2 2 2 2 2 2 2 2 2 2 2 2 2 2 2 3 2 2 2 2 2 2 2 2 2 3 2 2 2 2 2 2 2 2 2 2 2 2 2 3 0 0 0 0 0 
0 3 2 2 2 2 2 2 2 2 2 3 3 3 3 2 2 2 2 2 3 2 2 2 2 2 2 2 2 2 3 2 2 2 2 2 3 3 3 3 3 2 2 2 3 0 0 0 0 0 
0 3 2 2 2 2 2 2 2 2 2 3 1 1 3 2 2 2 2 2 3 2 2 2 2 2 2 2 2 2 3 2 2 2 2 2 3 1 1 1 3 2 2 2 3 0 0 0 0 0 
0 3 2 2 2 2 2 2 2 2 2 3 0 0 3 2 2 2 2 2 1 2 2 2 2 2 2 2 2 2 1 2 2 2 2 2 3 0 0 0 3 2 2 2 3 0 0 0 0 0 
0 3 3 3 3 18 18 18 3 3 3 3 0 0 3 2 2 2 2 2 4 2 2 2 2 2 2 2 2 2 4 2 2 2 2 2 3 0 0 0 3 2 2 2 3 0 0 0 0 0 
0 1 1 1 3 2 2 2 3 1 1 1 0 0 3 2 2 2 2 2 2 2 2 2 2 2 2 2 2 2 2 2 2 2 2 2 3 0 0 0 3 2 2 2 3 0 0 0 0 0 
0 0 0 0 3 2 2 2 3 0 0 0 0 0 3 2 2 2 2 2 2 2 2 2 2 2 2 2 2 2 2 2 2 2 2 2 3 0 0 0 3 2 2 2 3 0 0 0 0 0 
3 3 3 3 3 2 2 2 3 3 3 3 3 0 3 2 2 2 2 2 2 2 2 2 2 2 2 2 2 2 2 2 2 2 2 2 3 0 0 0 3 2 2 2 3 0 0 0 0 0 
3 1 1 1 1 18 18 18 1 1 1 1 3 0 3 3 3 3 3 3 3 3 3 3 3 3 3 3 3 3 3 3 3 3 3 3 3 0 0 0 3 2 2 2 3 0 0 0 0 0 
3 4 4 4 6 2 2 2 5 4 4 4 3 0 1 1 1 1 1 1 1 1 1 1 1 1 1 1 1 1 1 1 1 1 1 1 1 0 0 0 3 2 2 2 3 0 0 0 0 0 
3 2 2 2 2 2 2 2 2 2 2 2 3 0 0 0 0 0 0 0 0 0 0 0 0 0 0 0 0 0 0 0 0 0 0 0 0 3 3 3 3 2 2 2 3 3 3 3 0 0 
3 2 2 2 2 2 2 2 2 2 2 2 3 0 0 0 0 0 0 0 0 0 0 0 0 0 0 0 0 0 0 0 0 0 0 0 0 3 1 1 1 18 18 18 1 1 1 3 0 0 
3 2 2 2 2 2 2 2 2 2 2 2 3 0 0 0 0 0 0 0 0 0 0 0 0 0 0 0 0 0 0 0 0 0 0 0 0 3 4 4 6 2 2 2 5 4 4 3 0 0 
3 2 2 2 2 2 2 2 2 2 2 2 3 0 0 0 0 0 0 0 0 0 0 0 0 0 0 0 0 0 0 0 0 0 0 0 0 3 2 2 2 2 2 2 2 2 2 3 0 0 
3 2 2 2 2 2 2 2 2 2 2 2 3 0 0 0 0 0 0 0 0 0 0 0 0 0 0 0 0 0 0 0 0 0 0 0 0 3 2 2 2 2 2 2 2 2 2 3 0 0 
3 2 2 2 2 2 2 2 2 2 2 2 3 0 0 0 0 0 0 0 0 0 0 0 0 0 0 0 0 0 0 0 0 0 0 0 0 3 2 2 2 2 2 2 2 2 2 3 0 0 
3 3 3 3 3 3 3 3 3 3 3 3 3 0 0 0 0 0 0 0 0 0 0 0 0 0 0 0 0 0 0 0 0 0 0 0 0 3 3 3 3 3 3 3 3 3 3 3 0 0 
1 1 1 1 1 1 1 1 1 1 1 1 1 0 0 0 0 0 0 0 0 0 0 0 0 0 0 0 0 0 0 0 0 0 0 0 0 1 1 1 1 1 1 1 1 1 1 1 0 0 
